acquired - приобретенный, накопленный
admirable - превосходный, замечательный
advent - пришествие, наступление, приход
anticipation - ожидание, предвкушение
appreciate - ценить, понимать, принимать во внимание
appropriate - подходящее, соответствующи
aptitude - способность
arduous - трудный
ascertain - констатировать, устанавливать, выяснять
assign - назначать, присваивать
assuming - предполагать, думать, взять на себя
auxiliarie - помощник, вспомогательное предприятие
avow - признавать, признавать факт
baffling - сбивающий с толку, обескураживающей
beaker - мензурка, химический стакан
beyond - вне, после, за
binge watch - делать безостановочно(смотреть не отрывая глаз)
bizarre - странный, причудливый
bosom - грудь
bounce - подпрыгивать, отскок
burden - груз, бремя
carb - углевод, карбюратор
caved - сдался, прогнулся
certainly - конечно, безусловно
challenge - проблема, испытание, вызов 
chap - парень, малый, глава
chase - гнаться, преследовать
coincidence - совпадение, стечение обстоятельств
collar - воротник, ошейник
comb through - прочесывать, покопаться
commit - совершать, фиксировать
compile - составлять, подготовить, скомпилировать
confidently - уверенно, смело, самоуверенно
conning - обман, дурачит
conscience - совесть, сознание
constipation - запор
conventional - общепринятый, обычный, традиционный
convince - убеждать, уверять
corroborate - подтверждать, подкреплять
cosy - уютный, удобный
crave - жаждать, желать
crutch - костыль, опора
curse - проклятие, ругательство
dare - осмелиться, дерзать
daring - смелый, дерзкий
decrepit - дряхлый, ветхий
defiant - дерзкий, непокорный 
delve - копаться, углубиться
deteriorate - портиться, ухудшаться, деградировать
devastated - потрясенный, подавленный, опустошенный
devote - посвятить, уделять
did the trick - сделал свое дело, это сработало
diddle - обманывать, надувать
diligent - прилежный
disgrace - позор
disgusting - отвратительный
disrupt - нарушать, разрушать, подорвать
distract - отвлекать
diversity - разнообразие, многообразие 
dread - страх, боязнь
drip - капля, капельница
embarrass - смущать, стеснят
encourage - поощрять, поддерживать
endorsement - поддержка, одобрение
entail - повлечь за собой, вызывать, предполагать
ergo - эрго, следовательно, итак
eventually - в итоге, в конечном счете
excel - преуспеть, превзойти, превосходить
excessive - чрезмерный, излишний
expectation - ожидание, надежда
expose - разоблачить, незащищенный
fair - справедливый, честный
fees - сборы
fell out - выпал, поссорились
figure out - выяснить, понимать, придумать, решить
find out - выяснить, узнавать, понять
first of all - прежде всего, во-первых
flock - стадо, стая
foe - враг, противник
folks - народ, близкие
foreboding - предчувствие, предзнаменование
forehead - лоб
fraud - мошенник, обман, подделка
fungal - грибковый
furnished - меблированный
futile - бесполезный, пустой
gauge - измерять, оценивать, калибр
geared - приспособлен
genuine - подлинный, неподдельный, настоящий
glib - бойкий
gloomily - мрачно, угрюмо
go ahead - вперед, продолжать
go out with - встречаться с
goring - бодаться
gossip - сплетни, слухи
gutless - трусливый, безжалостный
hangover - похмелье, пережиток, наследие
harbor - гавань, порт
hence - следовательно, отсюд
hiking - пеший туризм
hone - отточить
hood - капот, капюшон
hooker - проститутка, шлюха
hurl - швырять, метать
impact - влияние, воздействие
impair - препятствовать, ослаблять, ухудшать
imposter - самозванец, мошенник
inadvertently - непреднамеренно, случайно
inconclusive - неубедительный
injure - ранить, повредить
insulation - изоляция
integrity - честность, целостность, неприкосновенность
interfere - вмешиваться, препятствовать
landline - стационарный, стационарный телефон, городской телефон
lawsuit - иск, судебный процесс
lenient - мягкий, снисходительный
lesion - поражение, повреждение
lest - чтобы, как бы не
liable - ответственный, подлежащий
loathe - ненавидеть, чувствовать отвращение
lump - кусок, шишка
lurking - скрывается, таиться
maiden name - девичья фамилия
measles - корь
moldy - заплесневелый, обветшалый
moron - придурок, идиот
obituary - некролог, список умерших
obscure - смутный, неясный
outwit - обмануть, перехитрить, провести
overall - в общем и целом, совокупный
overcome - превосходить, преодолевать
overreact - остро реагировать, паниковать
overwhelm - подавлять, сокрушать, ошеломить
pack - пакет, стая
pale - бледный
paltry - ничтожный
patch - пластырь, заплата
perish - погибнуть
perverse - порочный, извращенной
petal - лепесток
pissed - злой, пьяный, бухой
pit - яма, шахта, карьер
pity - жалость, сострадание
plethora - изобилие, полнокровие
poise - уравновешенность, самообладание
pretentious - показной, притязательный, много о себе возомнивший
probable - вероятный, возможный
processed - обработанный
proclivity - склонность, предрасположенность
prospects - перспективы, виды
puppy - щенок, молокосос
put up - строить, мириться 
rabies - бешенство, водобоязнь
rather - скорее
real estate - недвижимость, недвижимое имущество
reckless - безрассудный
refute - опровергнуть
rehab - реабилитация, восстановление
reimburse - возмещать, возвращать
reinvigorate - оживить, активизировать
repeal - отменить, аннулировать
retain - удерживать, сохранять
retrieval - поиск, извлечение, восстановление
ridicule - насмешка, высмеивать
ripe - спелый, зрелый
rot - гнить
rouse - будить, разбудить
savoury - пикантный, вкусный, чабер
scattere - рассыпать
scythe - коса
sealed - запечатанный, герметичный
seam - шов, стык
second to none - непревзойденный, нет равных
sedate - успокаивать, степенный, спокойный
severe - серьезный, тяжелые
severity - строгость, суровость
sheer - чистый, явный
shove - толчок, пихать
shrine - храм, святыня
shrink - психиатр, сокращать, сжиматься
sink - раковина, слив, сток
skulk - красться, симулянт
slight - слабый, легкий, незначительный
slippery - скользкий
smooth - гладкий, ровный
smudge - пятно, клякса
smug - самодовольный, чопорный
snap - щелчок, кнопка, хватка
sneak - красться, пробраться, проникнуть
snippy - надменный, отрывистый
snooze - вздремнуть, прилечь
sore - больной, воспаленный
sorting it out - разбираясь с этим, решить
speechless - безмолвный, онемевший
spinster - старая дева, незамужние
spit - плеват
spoil - портить, портиться 
spot - пятно, место, обнаруживать
sprout - росток, побег
staple - скрепка, сшитый
stark - суровый, резко, совершенно
stat - немедленно, срочно
stay up - не спать, засиживайся
stiff - жесткий, строгие
stir - переполох, расшевелить
stock - склад, запас, акции
strive - стремиться, добиваться
stroke - инсульт, удар
strut - стойка, подпора
stunt - трюк, фокус
substitute - заменять
subtle point - тонкий момент
successive - последовательный
suffocate - задыхаться, душить
surveyor - геодезист топограф маркшейдер инспектор
sustain - поддерживать, выдерживать
sustainable - стабильный, устойчивый
sweetheart - дорогой, возлюбленный
swelling - опухоль, отек
swoop - ворваться, налетать
take a plunge into - погрузиться во что-то
take its toll - иметь негативные последствия, взять свое, сказываться
tension - напряжени, натяжение
terrestrial - земной, наземный
tetanus - столбняк
thence - оттуда
thingies - рюшечки, вещицы
thusly - таким образом
tide - прилив, волна
tile - плитка, черепица
tis - этот
toe - палец, носок
toll - потери, дань
toss - бросать, жеребьевка
tough - жесткий, тяжелый
trail off - затихать
treat - лечить, обращаться, удовольствие
tricky - сложный, хитрый, каверзный
turf - дерн, торф
turn out - оказаться, получится
unassigned - не назначен
underestimate  - недооценивать
unearth - раскопать, откопать, выяснить
unholy - нечестивый, порочный
unprompted - самопроизвольный, спонтанный, без подсказки
unreliable - ненадежный
vaguely - смутно, расплывчато
venture - риск, авантюра, предприятие
veracity - правдивость, достоверность
vigilant - бдительный
weird - странный, непонятный
whereupon - после чего, вследствие чего
whether - ли
wonder - чудо, удивление, думать, задуматься
worn - изношенный
worthy - достойный
wreck - крушение, авария

<#999#>
258
18-27-93-43-56-0C-2E-8D-45-ED-6F-7C-CC-AA-EF-3D
43-F9-C8-0E-9C-B5-00-7B-1C-32-FC-AF-3A-DA-CD-D4
A9-27-DD-34-BD-17-94-D2-BD-61-28-99-4D-5A-70-63
8E-7D-2F-56-84-5A-9D-81-8C-7A-F6-F3-B5-5F-9E-A9
82-45-E4-CB-F1-9A-C3-0F-DD-E6-B8-7F-49-1C-DF-F9
11-8F-94-AA-6E-74-52-D5-D7-39-A7-78-7A-13-76-BC
89-21-92-B5-B8-78-D8-EB-F5-7D-EE-0E-B5-CA-03-00
38-14-B9-2A-47-29-61-DB-7C-51-31-91-EA-FC-6C-01
A8-AE-E3-BF-FC-54-78-4D-59-EB-B3-6F-C9-DA-E8-0F
D9-85-B2-0C-0D-48-A8-48-6B-21-E6-5D-53-BA-4E-90
