Абхазия - Сухуми (Сухум)
Австралия - Канберра
Австрия - Вена
Азербайджан - Баку
Албания - Тирана
Алжир - Алжир
Ангола - Луанда
Андорра - Андорра-ла-Велья
Антигуа и Барбуда - Сент-Джонс
Аргентина - Буэнос-Айрес
Армения - Ереван
Афганистан - Кабул
Багамские острова - Нассау
Бангладеш - Дакка
Барбадос - Бриджтаун
Бахрейн - Манама
Беларусь - Минск
Белиз - Бельмопан
Бельгия - Брюссель
Бенин - Порто-Ново
Болгария - София
Боливия - Ла-Пас
Босния и Герцеговина - Сараево
Ботсвана - Габороне
Бразилия - Бразилиа
Бруней - Бандар-Сери-Бегаван
Буркина-Фасо - Уагадугу
Бурунди - Бужумбура
Бутан - Тхимпху
Вануату - Вила
Ватикан - Ватикан
Великобритания - Лондон
Венгрия - Будапешт
Венесуэла - Каракас
Восточный Тимор - Дили
Вьетнам - Ханой
Габон - Либревиль
Гайана - Джорджтаун
Гаити - Порт-о-Пренс
Гамбия - Банжул
Гана - Аккра
Гватемала - Гватемала
Гвинея - Конакри
Гвинея-Бисау - Бисау
Германия - Берлин
Гондурас - Тегусигальпа
Гренада - Сент-Джорджес
Греция - Афины
Грузия - Тбилиси
Дания - Копенгаген
Джибути - Джибути
Доминика - Розо
Доминикана - Санто-Доминго
Египет - Каир
Замбия - Лусака
Зимбабве - Хараре
Йемен - Сана
Израиль - Иерусалим
Индия - Нью-Дели
Индонезия - Джакарта
Иордания - Амман
Ирак - Багдад
Иран - Тегеран
Ирландия - Дублин
Исландия - Рейкьявик
Испания - Мадрид
Италия - Рим
Кабо-Верде - Прая
Казахстан - Астана
Камбоджа - Пномпень
Камерун - Яунде
Канада - Оттава
Катар - Доха
Кения - Найроби
Кипр - Никоcия
Киргизия - Бишкек
Кирибати - Тарава
Китай - Пекин
Колумбия - Богота
Коморские острова - Морони
Конго - Браззавиль
Конго (Демокр. респуб.) - Киншаса
Корея Северная - Пхеньян
Корея Южная - Сеул
Косово - Приштина
Коста-Рика - Сан-Хосе
Кот-д'Ивуар - Ямусукро
Куба - Гавана
Кувейт - Эль-Кувейт
Кыргызстан - Бишкек
Лаос - Вьентьян
Латвия - Рига
Лесото - Масеру
Либерия - Монровия
Ливан - Бейрут
Ливия - Триполи
Литва - Вильнюс
Лихтенштейн - Вадуц
Люксембург - Люксембург
Маврикий - Порт-Луи
Мавритания - Нуакшот
Мадагаскар - Антананариву
Македония - Скопье
Малави - Лилонгве
Малайзия - Куала-Лумпур
Мали - Бамако
Мальдивы - Мале
Мальта - Валетта
Марокко - Рабат
Маршалловы острова - Маджуро
Мексика - Мехико
Микронезия - Паликир
Мозамбик - Мапуту
Молдова - Кишинев
Монако - Монако
Монголия - Улан-Батор
Мьянма - Янгон (Рангун)
Намибия - Виндхук
Науру - Ярен
Непал - Катманду
Нигер - Ниамей
Нигерия - Абуджа
Нидерланды - Амстердам
Никарагуа - Манагуа
Новая Зеландия - Веллингтон
Норвегия - Осло
ОАЭ - Абу-Даби
Оман - Маскат
Осетия Южная - Цхинвали
Пакистан - Исламабад
Палау - Корор
Панама - Панама
Папуа-Новая Гвинея - Порт-Морсби
Парагвай - Асунсьон
Перу - Лима
Польша - Варшава
Португалия - Лиссабон
Пуэрто-Рико - Сан-Хуан
Россия - Москва
Руанда - Кигали
Румыния - Бухарест
Сальвадор - Сан-Сальвадор
Самоа - Апиа
Сан-Марино - Сан-Марино
Сан-Томе и Принсипи - Сан-Томе
Саудовская Аравия - Эр-Рияд
Свазиленд - Мбабане
Сейшельские Острова - Виктория
Сенегал - Дакар
Сент-Винсент и Гренадины - Кингстаун
Сент-Китс и Невис - Бастер
Сент-Люсия - Кастри
Сербия - Белград
Сингапур - Сингапур
Сирия - Дамаск
Словакия - Братислава
Словения - Любляна
Соломоновы острова - Хониаpа
Сомали - Могадишо
Судан - Хаpтум
Суринам - Паpамаpибо
США - Вашингтон
Сьерра-Леоне - Фpитаун
Таджикистан - Душанбе
Тайвань - Тайпей
Таиланд - Бангкок
Танзания - Додома
Того - Ломе
Тонго - Нукуалофа
Тринидад и Тобаго - Порт-оф-Спейн
Тувалу - Фунафути
Тунис - Тунис
Туркменистан - Ашхабад
Турция - Анкаpа
Уганда - Кампала
Узбекистан - Ташкент
Украина - Киев
Уругвай - Монтевидео
Фиджи - Сува
Филиппины - Манила
Финляндия - Хельсинки
Франция - Париж
Французская Полинезия - Папеэте
Хорватия - Загреб
ЦАР - Банги
Чад - Нджамена
Черногория - Цетине
Чехия - Прага
Чили - Сантьяго
Швейцария - Берн
Швеция - Стокгольм
Шри-Ланка - Коломбо
Эквадор - Кито
Экваториальная Гвинея - Малабо
Эритрея - Асмэра
Эстония - Таллинн
Эфиопия - Аддис-Абеба
ЮАР - Претория
Ямайка - Кингстон
Япония - Токио

<#999#>
200
AA-A5-D4-A8-60-2A-2F-31-3E-73-F7-35-B2-2B-2B-6E
