Кихон (基本, きほん букв. "корни-основы") — это японский термин, означающий «основы» или «азы». Используется для обозначения базовых техник, которые преподаются и практикуются в большинстве японских боевых искусств.
	Практика и совершенствование кихона необходимы для обучения более сложным техникам, и включает в себя практику правильной постановки тела и дыхания во время отработки таких основных элементов как стойки, удары руками и ногами, блоки и толчки, в том числе и при исполнении кихон-ката.
	Кихон — это не только отработка правильного исполнения техник, но также и воспитание будоки, его духа и мироощущения.
	
Ка́та (型 или 形) — формализованная последовательность движений, связанных принципами ведения поединка с воображаемым противником или группой противников. По сути, является квинтэссенцией техники конкретного стиля боевых искусств. Аналогично таолу в ушу и тхылю в тхэквондо. В школе современного карате Дзёсиндо в определение ката дополнительно внесено понятие ката как эталонного образца техники карате для подражания и изучения.
	Принцип изучения боевого искусства на основе ката состоит в том, что повторяя ката многие тысячи раз, практик боевого искусства приучает своё тело к определённого рода движениям, выводя их на бессознательный уровень. Таким образом, попадая в боевую ситуацию, тело работает «само» на основе рефлексов, вложенных многократным повторением ката. Также считается, что ката обладают медитативным воздействием. 
	
Кумите́ (組手 — букв. «переплетённые руки», схватка) — понятие японских боевых искусств, включающее в себя все разновидности боя на татами (тренировочный, соревновательный, аттестационный), является одним из основных разделов современного карате, наряду с ката и кихон.
	Зачастую кумите является одновременно и целью (соревнования, самооборона) и средством боевых искусств (отработка различных навыков и техник). Само по себе является конечной формой реализации всего технического и тактического арсенала практикующего, также его физической подготовки. Будока на начальном этапе обучения, с целью предотвращения травматизма, не допускается к свободному бою.
	
	
КАРАТЭ 	Пустая  рука 	
ШОТОКАН (Сётокан) 	 «Дом  Шото» (Сёто)
РЭЙ / ОСС 	Приветствия 	
ДОДЗЁ-НИ-РЭЙ 	Приветствие  зала 	
ОТОГАЙ-НИ-РЭЙ 	Поклон взаимный 	КАТА – ВАДЗА 	Техника  комплексов
СЭНСЭЙ-НИ-РЭЙ 	Поклон  учителю 	ТАЙРЁКУ – ВАДЗА 	Техника физ. силы
МОКУСО 	Начать  медитацию 	СУЦУРЁКУ – ВАДЗА 	Техника  мощности
МОКУСО-ЯМЭ 	Закончить медитацию 	НАГЭ – ВАДЗА 	Техника  бросков
МОТО-НО-ИТИ 	Занять  свои  места 	РЭНЗОКУ – ВАДЗА 	Техника  связок
МУКОМА-ТЭ 	Построится 	КАВАШИ – ВАДЗА 	Техника перемещения
СОРЭМА-ТЭ 	Разойтись трен.оконч. 	ТАМЭШИВАРИ 	Разбивание предметов
КАРАТЭ-ГИ (кимоно) 	Костюм  для  каратэ 	ТОБИ-КОНДЭ-АШИ 	Прыжковый  шаг
ОБИ 	Пояс  для  каратэ-ги 	СОРИ-КОНДЭ-АШИ 	Скрёстный  шаг
СЭНПАЙ 	Помощник  учителя 	МАВАРИ-АШИ 	Поворотный  шаг
СЭНСЭЙ 	Учитель (наставник) 	ОКУРИ – АШИ 	Приставной  шаг
ШИХАН 	Руководитель  школы 	БУНКАЙ 	Разбор боевого прим-я
ЯМЭ 	Стоп, остановится 	АКА 	Кр-ый пояс на  сор-иях
ЯСМЭ 	Отдыхать, расслабься 	СИРО 	Белый пояс на  сор-иях
СЭЙДЗА 	Сесть  свободно 	ТАЙКИЁКУ 	Ката«Великий предел»
СЭЙДЗА-ДЗАДЗЭН 	Сесть  на  колени 	ХЭЙАН 	Ката  «Мир и покой»
КИРИЦУ  (татэ) 	Встать, вертикально 	
ХАДЖИМЭ 	Начинайте 	
СУДЗУКЭТА 	Продолжайте 	
СЭЙ 	Команда  на  выкрик 	
СКИ 	Приготовиться 	
КИМЭ 	Концентрация энергии 	
КИЯ   (киай) 	Воинственный  крик 	
КАЙ-ТЭ 	Разворот  короткий 	
МАВА-ТЭ 	Разворот  длинный 	
ДЗОДАН 	Верхний  уровень 	
ЧУДАН 	Средний  уровень 	
ГЕДАН 	Нижний  уровень 	
МАЭ 	Вперёд 	
ЁКО 	Боковой 	
УШИРО       	Назад 	
МАВАШИ  	Круговой 	
ОТОШИ      	Вниз  опускающий 	
АГЭ          	Вверх  восходящий 	
ХИКИ-ТЭ 	Отдёрнуть  руку 	
ХИКИ-АШИ 	Отдёрнуть  ногу 	
КАМАЭ 	Боевое  положение 	
ДАЧИ 	Стойка 	
ЦУКИ 	Удар  рукой 	
ГЭРИ 	Удар  ногой 	
УКЭ 	Защита 	 
ТОРИ 	Атакующий
МИГИ 	Право 	
ИДАРИ 	Лево 	
КАТА 	Комплекс  (форма) 	
КИХОН 	Базовые  приёмы 	
КУМИТЭ 	Бой с  партнёром 	

ИЧ(ТИ) 	 1 – один
НИ 	 	 2 – два
САН 	 3 – три
Щ(С)И 	 4 – четыре
К(Г)О 	 5 – пять
РОК	 	 6 – шесть
СИЧ(ТИ)  7 – семь
ХАЧ(ТИ)  8 – восемь
КЮ 	 	 9 – девять
ДЗЮ 	10 – десять

КЮ 	Ученическая  ступень
ДАН 	 Мастерская  степень
Поясная  система  используемая  в  «ПРОФИ»
10-КЮ 	Пр. ношения  кимоно
9-КЮ   Сиро  оби 	Белый  пояс
8-КЮ   Сиро  оби 	Белый с жёлт. концами
7-КЮ   Кииро  оби 	Жёлтый  пояс
6-КЮ Орэндзииро оби 	Оранжевый  пояс
5-КЮ  Мидорииро оби 	Зелёный  пояс
4-КЮ   Аойиро  оби 	Синий  пояс
3-КЮ    Тяиро  оби 	Св. коричневый  пояс
2-КЮ    Тяиро  оби 	Коричневый  пояс
1-КЮ    Тяиро  оби 	Тём. коричневый  пояс
1- ДАН   Кюрой  оби 	Чёрный  пояс

АТЭ – ВАДЗА 	Техника  рук
УКЭ – ВАДЗА 	Техника  блоков
ГЭРИ – ВАДЗА 	Техника  ног


дзэнкуцу-дачи - основная атакующая стойка с выпадом вперёд
Киба-дати (яп. 騎馬立ち — стойка всадника) — статичная боевая стойка














