a little bit later - чуть позже
abandone - бросать, покидать, оставлять
abdomen - брюшная полость
abroad - за границей
accommodation - приспособление, размещение
acute - острый, резкий, проницательный
addicte - наркоман
admit - признавать, допускать
adoption - принятие
advertise - рекламировать
advice - совет, мнение
affiliate - филиал, отделение
ahead of time - заранее, досрочно
alleviate - облегчить
ancestor - предок
anniversary - годовщина, юбилей
annoying - раздражающий
approach - подход, приближение, метод
arrogent - высокомерный, надменный
assault - атака, нападение, штурм
attachment - вложения, привязанность, приложение
award - награда
backache - боль в спине
backward - назад
baggage-clame - выдача багажа
bamboo - бамбук
bark - гавкать
barren - бесплодный
bay - залив, бухта
bead - шарик, бусинка, прицел
beet - свекла
behind the time - c опозданием, отстал от жизни, отстает от времени 
bend - гнуть
bet - держать пари
betray - предавать
bit - немного, бит, укус
bitter - горький, резкий
blade - лезвие
bless you - будьте здоровы
board games - настольные игры
bonfire  - костер
booze - выпивка
borrow - одолжить, брать взаймы
botanist - ботаник
brag - хвастаться
breakthrough - достижение, прорыв, открытие
bride - невеста
by-products - побочные элементы\продукты
carved - резной
cease - прекратить
cereal - каша
checkup - проверка, осмотр
chemist - аптекарь, химик
chemist's - аптека
chest - сундук, грудная клетка, сердце
chest of drawers - комод
chew - жевать
choosy - привередливый, разборчивый
chopsticks - палочки для еды
claim - претензия, требование, иск
climb - взбираться, подъем, восхождение
closet - уборная, чулан, стенной шкаф
coat - пальто
come up - появиться, приближаться
coming up - приближается, подойти
condamned - осужден, приговорен, обречен
confuse - смущать, сбивать с толку
consonant - согласный звук
contagious - заразительный, инфекционный
contribution - вклад 
convict - осужденный
convicts - осужденные
core - основной, ядро
corn - кукуруза 
cottage cheese - творог, домашний сыр
country gas station - страна бензоколонка
court - суд
craftsmen - мастер, ремеленник
crap - дерьмо, чепуха
creature - существо
credits and acknowledgments - благодарности и благодарности
cross-eyed - косоглазый
crowded - переполненный, перенаселенный
cupboard - буфет, шкаф
dairy products - молочные продукты
damned - треклятый
dangle - мотаться, болтаться, свесить
deal - сделка, контракт, иметь дело, распределять
decay - распад, разложение
dedicate - посвятить
deflecting - отклонение
dehidrated - обезвоженный
delightful - восхитительный
deprive - лишать, отнимать
despair - отчаяние, безысходность
despite - несмотря на
dig - копать, рыть
discharges - разряды
dismissal - увольнение
distinguish - различать, отличать
distinguished - выдающийся
draft - проект, набросок, черновой вариант
drown - тонуть
durable - прочный, долговечный
dye - краситель, цвет
earings - серьги
easy-going - беззаботный, добродушный
edge - край, окраина, грань, ребро
elevator - лифт
eliminate - устранять, ликвидировать, исключать
emergency - скорая медицинская помощь, чрезвычайный
endurence - выносливость
entertainer - конферансье
esophageal - пищеводный 
essential - существенный, важный
evidence - доказательство, улики
excess - превышение, избыток
exciting - захватывающий, волнующий
facing backward - лицом назад
fairy tales - сказки
fall over - упасть
fart - пердеть, пукать
fetch - принести, получать, выбирать
fiber - волокно, нить
flames - пламя
flash drive - флешка
flea - блоха
foil - фольга
follower - последователь
footer - нижний колонтитул
for the time being - на данный момент, в настоящее время
forced - принужденный, вынужденный
fortune-teller - гадалка
free perks - бесплатные льготы
frequent - частый, регулярный
frequently - часто
fur - шерсть
fussy - привередливый, капризный, нервный, суетливый
gain - прирост, прибыль
gain ground - продвигаться вперед
gap - зазор, пробел
gave birth - родила
gaze - взор, пристальный взгляд, пристально глядеть
geez - боже
generation - поколение
generous - щедрый
get engaged - обручиться
give away - отдавать
glacier - ледник
glimps - проблеск, намек
go Dutch - раздельный счёт, каждый платит за себя
goofy - тупой
goose - гусь
goosebumps - муршки
grain - крупа, зерно
greedy - жадный, алчный
greengrocer - овощной, продавец фруктов
grid - сетка
groom - жених
guilty - виновный
hairdryer - фен
handicap - инвалидность, гандикап
handsome - красивый,
handwriting - почерк
harmful - вредный, тлетворный, разлагающий
headline - заголовок
headrests - подголовники
heck - черт, подонок
herniate - грыжа
high time - пора, настало время
highlight - выделять, основной момент
honest - честный, искренний
horrifying - ужасающий, шокирующий
however - однако
humiliation - унижение
hung - повесили
hurt - повредить
hurtful - вредный, обидный
i dont mind - я не против
i figure - я предположил
impatient - нетерпеливый, раздражительный
implement - выполнять, осуществлять
implementing - реализации, осуществление, выполнение
in a rush - в спешке, второпях
in the nick of time - в самый последний момент, в самый раз
incapable - неспособный, недееспособный
initially - первоначально, изначально 
instead - вместо
institution - учреждение, заведение, организация
insufferable - невыносимый
iron - железо, утюг
irritable - раздражительный
ivory - слоновая кость
jack - разъем, розетка, домкрат
jack of all trades - мастер на все руки
jealous - завистливый
jealousy - зависть, ревность
jerk - придурок
jewelry - ювелирные украшения, драгоценности
jogging - пробежка, бег трусцой
kettle - чайник
kicker - кикер, футболист, нападающий, прикол
kidney - почка
kind - добрый, любезный
knight - рыцарь, конь, всадник
knitting - вязание
labore - трудиться
large volumes - большие объемы
latest generation technologies - технологии последнего поколеня
leak - течь, утечка
legal wisdom - юридическая мудрость
lid - крышка
likelihood - вероятность
loss - потеря, убыток
magic tricks - фокусы
make time - найти время, выделить время 
make up - 
manslouter - слуга
margin - запас, край, предел
masterpiece - шедевр
match - матч, спичка, совпадение
matching - соответствие
matchmarker - сваха
Me neither - Я тоже
meaninful - значимый
meaningless - бессмысленный 
meanwhile - тем временем
melt - плавиться, таять
Middle Ages - средневековье
miss - промахнуться, скучать, опаздать
mist - туман
moist - влажный, сырой
mood - настроение
mosque - мечеть
mother in law - свекровь
mush - каша, помехи
narrow - узкий
naval - военно-морской, морской
necklace - ожерелье
next to - рядом
no one - никто
nomade - кочевник
noodle - лапша
noticeable - заметный, приметный
numb - онемевший, оцепенелый
obesety - ожирение
occur - происходить, случаться
odor - запах, аромат
out of time - вне времени, несвоевременно, время истекло
outfit - костюм, снаряжение, оборудование, экипировка
overlook - не заметить, игнорировать
painkiler - болеутоляющее
patience - терпение, пасьянс
peer - равный, сверстник, вглядеться
personality traits - черты характера
persuade - уговаривает, убеждать
pet - домашний питомец
photovoltaic - фотоэлектрический
picky - придирчивый
pit - колодец
plastic bag - полиэтиленовый пакет
politeness - вежливость
porridge - каша
porselain - фарфор
powder - пудра
predecessor - предшественник
pressed for time - мало времени, не хватает времени
pull - тянуть, вытащить, вытянуть
push - толкать
put on weight - набрать вес
queue - очередь
radiant - сияющий
rebels - повстанцы, революционеры
recently - недавно
resume - возобновлять, итог, резюме
roasting - жарка, обжиг
rob - ограбить
roller coaster - американские горки, аттракцион
rude - грубый, неприличный
rug - ковер
sad - грустный 
scaffolding - строительные леса, подмостки
scholar - ученый
scored - забивать
screw up - облажаться
seagull - чайка
seizing - захват, заедание
serve time - отбывать срок, отбывать наказание
set a date - назначить дату
shape - вид, форма, образ
shared - общий, коллективный
shares - акции
sharper - жулик, шулер, острее
shawl - шаль, платок
shelve - полка
shiny - блестящий, солнечный
shore - берег, побережье
shy - застенчивый, робкий
sight - взгляд, зрелище, достопримечательность
sight - взгляд, зрелище, достопримечательность
silicon - кремний
silicone - силикон (Кремниевую долину, в которой сконцентрированы главные офисы множества ИТ-компаний, в русскоязычных источниках нередко ошибочно называют Силиконовой долиной, поскольку по-английски кремний называется «silicon» (а силикон называется «silicone»))
silly - глупый
skirt - юбка
skunk - скунс
skyscraper - небоскреб
slaker - лентяй
sled - санки, сани
spill - проливать, разливать
splendid - великолепный
spur - стимул, шпора, побуждение
squeeze - сжимать, выжимать
stagger - шататься
stash - тайник, копить
storeroom - кладовая
story line - сюжетная линия
storyteller - рассказчик, сказочник
stove - печь
straight - прямой
straightforward - прямолинейный
stray - плутать, заблудиться, блуждать, сбиваться с пути
strike - забастовка, стачка, удар
struggle - борьба
sunscreen - солнцезащитный крем
swan - лебедь, бард, поэт
swing - качать
syllable - слог
take a sip - глотни ка
take off - взлететь, снимать
thee - тебе, тобою
therefore - следовательно, поэтому
thief - вор
throat - глотка
throughout - на протяжении, в течение
throw away - выбрасывать
tidy - аккуратный, опрятный
tie - галстук
tin - олово, банка
titers - титры
to be a couch potato - лежать ничего не делат
to be contagious - быть заразным
to break bad habits - избавиться от вредных привычек
to checkin - регистрация
to do the dishes - мыть посуду
to eat out - есть вне дома
to give a crap - насрать
to ingratiate - снискать расположение, втираться в доверие
to mop - мыть
to tell the truth - по правде говоря
toastmaster - тамада
toothache - зубная боль
torturing - пытки, мучения
town hall - ратуша
traffic jam (traffic tail) - пробка
trainers - кросовки
treadmill - беговая дорожка
tune - настроить, звучать
tuple - кортеж
typo - опечатка
undivided - неделимый, целый
undivided attention - пристальное внимание
unfortunately - к сожелению
unlikely - маловероятно (It's possible, but unlikely)
unlikely process - маловероятный процесс
unto - к, до
up to - зависит от
upset - расстройство, огорчение
upsey - огорчать
upstair - наверху, в верхнем этаже
veil - вуаль, завеса
vowel - гласный звук
wander - интерестно, бродить 
wardrobe - гардероб
wasp - оса
wax - воск, парафин
weed - сорняк, табак, марихуана
weep - плакать, рыдать
whale - кит
what the heck - какого черта
whenever - в любое время
whipp - хлестать
wide - широкий, большой, обширный
withstand - выдерживать
wizard - маг, волшебник
wondering - интересный, любопытно
worth - стоимость, цена
wrestler - рестлер
wrist - запястье
yell - кричать
native - родной, природныйneedless - ненужный
keep in touch - поддерживать связь
snapdragon - львиный зев
tongue - язык
attic - чердак
passage - проход, проезд, отрывок
encumber - загромождать, обременять, мешать
eyeball - глазное яблоко, глаз
quiver - колчан, дрожь
dormant - спящий, дремлющий, бездействующий
disability - инвалидность
hanging out - тусоваться, зависать
lodge - ложа, домик
scrape -  соскребать, царапать
